81 81 81 81 81 81 81 81 81 81 81 81 81 81 81 81 81 81 81 81 81 81 81 81 81 81 81 81 81 81 81 81 81 81 81 81 81 81 81 81 81 81 81 81 81 81 81 81 81 81 
81 81 81 81 81 81 81 81 81 81 81 81 81 81 81 81 81 81 81 81 81 81 81 81 81 81 81 81 81 81 81 81 81 81 81 81 81 81 81 81 81 81 81 81 81 81 81 81 81 81 
81 81 81 81 81 81 81 81 81 81 81 81 81 81 81 81 81 81 81 81 81 81 81 81 81 81 81 81 81 81 81 81 81 81 81 81 81 81 81 81 81 81 81 81 81 81 81 81 81 81 
81 81 81 81 81 81 81 81 81 81 81 81 81 81 81 81 81 81 81 81 81 81 81 81 81 81 81 81 81 81 81 81 81 81 81 81 81 81 81 81 81 81 81 81 81 81 81 81 81 81 
81 81 81 81 81 81 81 81 81 81 81 81 81 81 81 81 81 81 81 81 81 81 81 81 81 81 81 81 81 81 81 81 81 81 81 81 81 81 81 81 81 81 81 81 81 81 81 81 81 81 
81 81 81 81 81 81 81 81 81 81 81 81 81 81 81 81 81 81 81 81 81 81 81 81 81 81 81 81 81 81 81 81 81 81 81 81 81 81 81 81 81 81 81 81 81 81 81 81 81 81 
81 81 81 81 81 81 81 81 81 81 80 81 80 82 80 80 82 80 81 81 81 81 81 81 81 81 81 80 80 80 80 80 82 80 80 80 80 82 80 80 81 81 81 81 81 81 81 81 81 81 
81 81 81 81 81 81 81 81 81 81 80 81 80 80 80 80 80 80 80 82 80 80 80 80 80 82 82 80 80 81 81 81 81 80 80 80 80 96 80 82 81 81 81 81 81 81 81 81 81 81 
81 81 81 81 81 81 81 81 81 81 80 80 80 80 82 80 82 80 81 81 81 81 81 80 80 80 80 80 80 81 81 81 81 81 81 81 80 80 80 80 81 81 81 81 81 81 81 81 81 81 
81 81 81 81 81 81 81 81 81 81 81 81 81 80 80 80 80 81 81 80 80 96 81 81 81 81 80 80 80 80 80 82 81 81 81 81 81 81 80 81 81 81 81 81 81 81 81 81 81 81 
81 81 81 81 81 81 81 81 81 81 81 81 81 81 81 81 80 80 80 82 80 80 81 81 81 81 81 80 80 82 80 80 80 80 80 81 81 81 80 80 81 81 81 81 81 81 81 81 81 81 
81 81 81 81 81 81 81 81 81 81 80 81 81 81 81 81 81 81 81 80 81 81 81 81 81 81 81 81 81 80 80 130 80 80 80 82 80 81 80 80 81 81 81 81 81 81 81 81 81 81 
81 81 81 81 81 81 81 81 81 81 80 80 81 81 81 81 81 81 80 82 81 81 81 81 81 81 81 81 81 81 80 80 82 80 80 80 80 81 80 80 81 81 81 81 81 81 81 81 81 81 
81 81 81 81 81 81 81 81 81 81 82 80 81 80 80 80 81 81 81 80 81 81 81 81 81 81 81 81 81 81 81 80 80 80 81 81 81 81 81 81 81 81 81 81 81 81 81 81 81 81 
81 81 81 81 81 81 81 81 81 81 80 80 80 80 81 80 80 80 81 81 81 81 81 81 81 81 81 81 81 81 81 80 80 81 81 81 81 81 81 81 81 81 81 81 81 81 81 81 81 81 
81 81 81 81 81 81 81 81 81 81 96 81 81 81 80 82 81 80 80 130 81 81 81 81 81 81 81 81 81 81 80 80 81 81 81 80 80 80 81 81 81 81 81 81 81 81 81 81 81 81 
81 81 81 81 81 81 81 81 81 81 81 81 80 82 80 81 81 81 80 80 80 81 81 81 81 81 81 81 81 80 80 80 81 81 81 81 81 80 81 81 81 81 81 81 81 81 81 81 81 81 
81 81 81 81 81 81 81 81 81 81 81 82 80 80 81 81 80 80 80 81 80 81 81 81 81 81 81 80 80 82 80 81 81 80 80 80 80 80 81 81 81 81 81 81 81 81 81 81 81 81 
81 81 81 81 81 81 81 81 81 81 81 80 80 81 81 82 80 81 81 80 80 80 81 81 81 81 80 80 80 80 81 81 80 80 80 82 80 80 80 81 81 81 81 81 81 81 81 81 81 81 
93 93 93 93 93 93 93 95 81 81 81 130 81 81 80 80 81 81 80 80 80 80 81 81 80 80 80 130 80 81 81 81 80 80 80 80 80 82 80 80 81 81 81 81 81 81 81 81 81 81 
83 83 83 83 83 83 83 90 81 81 81 81 81 80 80 80 81 80 80 80 81 81 81 81 81 80 80 82 80 81 81 81 81 81 81 81 80 80 80 80 81 81 81 81 81 81 81 81 81 81 
83 116 83 83 83 83 116 90 81 81 81 80 80 82 80 81 81 80 82 80 81 81 81 81 81 81 80 80 80 80 81 81 81 81 81 81 81 80 82 80 81 81 81 81 81 81 81 81 81 81 
83 83 83 83 83 83 83 90 81 81 80 80 80 80 81 81 80 80 80 80 81 81 81 81 81 81 81 80 80 80 81 80 80 80 81 81 81 81 130 80 81 81 81 81 81 81 81 81 81 81 
83 83 83 83 83 116 83 90 81 81 80 82 81 81 81 80 80 80 80 80 81 81 81 81 81 81 81 80 80 80 80 80 80 80 80 81 81 81 80 80 81 81 81 81 81 81 81 81 81 81 
83 83 83 83 83 83 83 90 81 81 130 80 80 80 80 80 80 82 80 80 81 81 81 81 81 81 81 80 80 80 81 80 80 80 81 81 81 80 80 80 81 81 81 81 81 81 81 81 81 81 
83 116 83 83 116 83 83 90 81 81 81 80 82 80 80 80 80 80 80 80 80 81 81 81 81 81 80 80 81 81 81 81 80 81 81 81 80 80 80 81 81 81 81 81 81 81 81 81 81 81 
83 83 83 83 83 83 83 90 81 81 80 80 80 80 80 80 80 80 80 80 80 80 81 81 80 80 80 80 80 81 81 81 81 81 80 80 80 80 81 81 81 81 81 81 81 81 81 81 81 81 
83 83 83 83 83 83 83 90 81 81 80 80 81 81 81 81 81 80 82 80 81 80 80 80 82 80 130 80 80 80 80 80 80 80 82 80 81 81 81 81 81 81 81 81 81 81 81 81 81 81 
83 116 83 83 83 116 83 90 81 81 80 81 81 81 81 81 81 81 80 80 80 81 81 80 80 80 80 80 80 81 80 82 81 80 80 80 80 81 81 81 81 81 81 81 81 81 81 81 81 81 
83 83 83 83 83 83 83 90 81 81 80 81 81 80 80 81 81 81 81 81 80 80 80 80 80 80 80 81 81 81 80 80 81 81 80 82 80 80 81 81 81 81 81 81 81 81 81 81 81 81 
83 83 116 83 83 83 83 90 81 81 80 81 80 82 80 81 81 81 81 81 80 80 96 81 81 81 80 80 80 80 80 80 81 81 80 80 82 80 81 81 81 81 81 81 81 81 81 81 81 81 
83 83 83 83 83 116 83 90 81 81 80 80 80 80 81 81 81 81 80 80 80 81 81 81 81 81 80 82 80 80 81 81 81 81 80 80 82 80 81 81 81 81 81 81 81 81 81 81 81 81 
83 116 83 83 83 83 83 90 81 81 80 82 80 81 81 80 80 80 80 80 80 81 81 81 81 81 80 80 80 81 81 81 81 81 80 80 80 82 80 81 81 81 81 81 81 81 81 81 81 81 
83 83 83 83 83 116 83 90 81 81 80 80 81 81 80 80 80 80 80 82 80 81 81 81 81 80 80 80 80 81 81 81 81 81 80 82 80 80 80 80 81 81 81 81 81 81 81 81 81 81 
83 83 83 83 83 83 83 90 81 81 80 80 81 81 80 80 80 80 82 80 80 81 81 81 81 80 80 82 80 81 81 81 81 80 80 80 80 81 81 80 81 81 81 81 81 81 81 81 81 81 
83 116 83 83 83 83 83 90 81 81 80 81 81 81 80 80 80 80 80 80 80 80 81 81 130 80 81 80 80 80 81 81 80 82 82 82 80 81 81 81 81 81 81 81 81 81 81 81 81 81 
83 83 83 83 116 83 83 90 81 81 80 80 80 80 80 80 80 80 82 80 80 80 80 81 81 80 81 81 82 80 81 80 80 80 80 96 80 80 81 81 81 81 81 81 81 81 81 81 81 81 
83 83 83 83 83 83 83 90 81 81 80 80 81 80 80 80 80 80 82 82 80 82 80 80 81 80 80 81 80 80 81 81 81 81 80 80 80 80 81 81 81 81 81 81 81 81 81 81 81 81 
83 83 83 83 83 83 83 90 81 81 130 81 81 80 81 81 80 80 80 80 80 80 80 80 80 81 80 81 81 80 80 81 81 81 80 80 80 80 80 81 81 81 81 81 81 81 81 81 81 81 
83 83 83 83 83 116 83 90 81 81 81 81 80 80 81 81 81 81 81 81 81 81 81 80 80 81 81 80 80 80 80 80 80 81 81 80 80 81 80 81 81 81 81 81 81 81 81 81 81 81 
83 83 116 83 83 83 83 86 95 81 82 80 80 80 80 81 81 81 81 81 81 81 81 80 81 81 81 81 81 80 81 80 80 81 81 80 80 80 82 80 81 81 81 81 81 81 81 81 81 81 
83 83 116 83 83 83 83 83 90 81 80 80 82 80 80 80 80 80 80 80 80 81 81 82 80 81 81 81 81 81 81 81 81 81 81 80 81 80 80 80 81 81 81 81 81 81 81 81 81 81 
83 83 83 83 83 83 83 83 90 81 80 80 80 80 80 82 80 80 80 82 80 81 81 80 80 80 80 80 80 80 80 81 81 81 81 80 81 80 130 80 81 81 81 81 81 81 81 81 81 81 
83 83 83 83 83 116 83 83 90 81 80 80 82 80 80 80 80 80 80 80 80 81 81 81 81 81 80 80 82 80 80 80 80 80 80 80 80 80 80 80 81 81 81 81 81 81 81 81 81 81 
116 83 83 83 83 83 83 83 86 93 93 93 93 93 93 95 81 81 81 81 81 81 81 81 81 81 81 81 81 81 81 81 81 81 81 81 81 81 81 81 81 81 81 81 81 81 81 81 81 81 
83 83 83 83 83 83 83 83 83 83 83 83 83 83 83 90 81 81 81 81 81 81 81 81 81 81 81 81 81 81 81 81 81 81 81 81 81 81 81 81 81 81 81 81 81 81 81 81 81 81 
83 83 83 116 83 83 83 83 83 83 83 83 83 116 83 90 81 81 81 81 81 81 81 81 81 81 81 81 81 81 81 81 81 81 81 81 81 81 81 81 81 81 81 81 81 81 81 81 81 81 
83 83 83 83 83 83 83 83 116 83 83 83 83 83 83 86 95 81 81 81 81 81 81 81 81 81 81 81 81 81 81 81 81 81 81 81 81 81 81 81 81 81 81 81 81 81 81 81 81 81 
83 83 83 83 83 83 83 83 83 83 83 83 83 83 83 83 86 93 95 81 81 81 81 81 81 81 81 81 81 81 81 81 81 81 81 81 81 81 81 81 81 81 81 81 81 81 81 81 81 81 
83 83 83 83 83 83 83 83 83 83 83 83 83 83 116 83 83 83 86 93 95 81 81 81 81 81 81 81 81 81 81 81 81 81 81 81 81 81 81 81 81 81 81 81 81 81 81 81 81 81 
