16 16 16 16 16 16 16 16 16 16 16 16 16 16 16 16 16 16 16 16 16 16 16 57 59 61 61 61 61 61 61 61 63 65 16 16 16 16 16 16 16 16 16 16 16 16 16 16 16 16 
16 16 16 16 16 16 16 16 16 16 16 16 16 16 16 16 16 16 16 16 16 16 16 57 59 61 61 61 61 61 61 61 63 65 16 16 16 16 16 16 16 16 16 16 16 16 16 16 16 16 
16 16 16 16 16 16 16 16 16 16 16 16 16 16 16 16 16 16 16 16 16 16 16 57 59 61 61 61 61 61 61 61 63 65 16 16 16 16 16 16 16 16 16 16 16 16 16 16 16 16 
16 16 16 16 16 16 16 16 16 16 16 16 16 16 16 16 16 16 16 16 16 16 16 57 59 61 61 61 61 61 61 61 63 65 16 16 16 16 16 16 16 16 16 16 16 16 16 16 16 16 
16 16 16 16 16 16 16 16 16 16 16 16 16 16 16 16 16 16 16 16 16 16 16 57 58 60 60 60 60 60 60 60 62 65 16 16 16 16 16 16 16 16 16 16 16 16 16 16 16 16 
16 16 16 16 16 16 16 16 16 16 16 16 16 16 16 16 16 16 16 16 16 16 16 56 55 55 55 55 54 55 55 55 55 64 16 16 16 16 16 16 16 16 16 16 16 16 16 16 16 16 
16 16 16 16 16 16 16 16 16 16 16 16 16 1 1 1 1 1 1 1 1 16 16 1 1 1 1 12 10 13 1 1 1 1 1 1 1 16 16 16 16 16 16 16 16 16 16 16 16 16 
16 16 16 16 16 16 16 16 16 16 16 16 1 1 1 16 16 16 16 16 1 16 16 1 1 1 1 8 3 7 1 1 1 1 1 1 1 1 16 16 16 16 16 16 16 16 16 16 16 16 
16 16 16 16 16 16 16 16 16 16 16 1 1 1 1 16 16 16 16 16 1 16 16 1 1 1 1 8 3 7 1 1 1 1 1 1 1 1 1 16 16 16 16 16 16 16 16 16 16 16 
16 16 16 16 16 16 16 16 16 16 1 20 21 21 21 21 21 21 21 22 1 1 1 1 1 1 1 8 3 7 1 1 1 1 1 1 1 1 1 1 16 16 16 16 16 16 16 16 16 16 
16 16 16 16 16 16 16 16 16 16 1 23 18 18 18 18 19 18 18 24 1 1 1 1 1 1 1 8 3 7 1 1 1 2 2 1 1 1 1 1 16 16 16 16 16 16 16 16 16 16 
16 16 16 16 16 16 16 16 16 16 1 23 18 19 18 18 18 18 18 24 1 1 1 2 1 1 1 8 3 7 1 1 1 1 1 1 1 1 1 1 16 16 16 16 16 16 16 16 16 16 
16 16 16 16 16 16 16 16 16 16 1 23 18 18 18 19 18 18 19 24 1 1 1 1 1 1 1 8 3 7 2 1 12 10 13 1 1 1 1 1 16 16 16 16 16 16 16 16 16 16 
16 16 16 16 16 16 16 16 16 16 1 25 26 26 26 26 26 26 26 27 1 1 1 1 1 1 2 8 3 7 1 1 8 3 7 1 2 1 1 1 16 16 16 16 16 16 16 16 16 16 
16 16 16 16 16 16 16 16 16 16 16 1 1 1 1 1 12 10 10 10 10 10 10 10 10 10 10 11 3 9 10 10 11 3 9 10 10 10 13 1 16 16 16 16 16 16 16 16 16 16 
16 16 16 16 16 16 16 16 16 16 16 16 16 1 1 1 8 3 3 3 3 3 3 3 3 3 3 3 3 3 3 3 3 3 3 3 3 3 7 1 16 16 16 16 16 16 16 16 16 16 
16 16 16 16 16 16 16 16 16 16 16 16 16 16 16 1 8 3 4 5 5 5 5 5 5 5 6 3 43 41 41 41 41 41 41 41 52 3 7 1 16 16 16 16 16 16 16 16 16 16 
16 16 16 16 16 16 16 16 16 16 12 10 10 10 10 10 11 3 7 16 16 16 16 16 16 16 8 3 44 40 40 40 40 40 40 40 45 3 7 1 16 16 16 16 16 16 16 16 16 16 
16 16 16 16 16 16 16 16 16 16 8 3 3 3 3 3 3 3 7 16 1 1 1 1 1 16 8 3 44 40 40 40 40 40 40 40 45 3 7 1 16 16 16 16 16 16 16 16 16 16 
16 16 16 16 16 16 16 16 16 16 14 5 5 5 5 5 6 3 7 16 1 1 2 1 1 16 8 3 44 40 40 40 40 40 40 40 45 3 7 1 16 16 16 16 16 16 16 16 16 16 
16 16 16 16 16 16 16 16 16 16 16 16 16 16 16 1 8 3 7 16 1 1 1 1 2 16 8 3 44 40 40 40 40 40 40 40 45 3 7 1 16 16 16 16 16 16 16 16 16 16 
16 16 16 16 16 16 16 16 16 16 16 16 16 1 1 1 8 3 7 16 1 1 1 1 1 16 8 3 44 40 40 40 40 40 40 40 45 3 7 1 16 16 16 16 16 16 16 16 16 16 
16 16 16 16 16 16 16 16 16 16 16 1 1 1 1 1 8 3 7 16 16 2 1 1 16 16 8 3 44 40 40 40 40 40 40 40 45 3 7 1 16 16 16 16 16 16 16 16 16 16 
16 16 16 16 16 16 16 16 16 16 1 12 10 10 10 10 11 3 9 10 10 10 10 10 10 10 11 3 51 46 46 46 46 46 46 46 53 3 7 1 16 16 16 16 16 16 16 16 16 16 
16 16 16 16 16 16 16 16 16 16 1 8 3 3 3 3 3 3 3 3 3 3 3 3 3 3 3 3 3 3 3 3 3 3 3 3 3 3 7 2 16 16 16 16 16 16 16 16 16 16 
16 16 16 16 16 16 16 16 16 16 1 8 3 3 3 3 3 3 3 3 3 3 3 3 3 3 3 3 3 3 3 3 3 3 3 3 3 3 7 1 16 16 16 16 16 16 16 16 16 16 
16 16 16 16 16 16 16 16 16 16 1 8 3 3 43 41 41 41 41 41 41 41 41 41 41 41 41 41 41 41 41 41 41 41 41 52 3 3 7 1 16 16 16 16 16 16 16 16 16 16 
16 16 16 16 16 16 16 16 16 16 1 8 3 3 44 42 66 66 66 66 66 66 66 66 66 66 66 66 66 66 66 66 66 66 42 45 3 3 7 1 16 16 16 16 16 16 16 16 16 16 
16 16 16 16 16 16 16 16 16 16 1 8 3 3 44 42 40 40 40 40 40 40 40 40 40 40 40 40 40 40 40 40 40 40 42 45 3 3 7 1 16 16 16 16 16 16 16 16 16 16 
16 16 16 16 16 16 16 16 16 16 1 8 3 3 44 42 40 40 40 40 40 40 40 40 40 40 40 40 40 40 40 40 40 40 42 45 3 3 7 1 16 16 16 16 16 16 16 16 16 16 
16 16 16 16 16 16 16 16 16 16 1 8 3 3 44 42 40 40 40 40 40 40 40 40 40 40 40 40 40 40 40 40 40 40 42 45 3 3 7 2 16 16 16 16 16 16 16 16 16 16 
16 16 16 16 16 16 16 16 16 16 1 8 3 3 44 42 40 40 40 40 40 40 40 40 40 40 40 40 40 40 40 40 40 40 42 45 3 3 7 1 16 16 16 16 16 16 16 16 16 16 
16 16 16 16 16 16 16 16 16 16 1 8 3 3 44 42 47 46 48 40 40 40 42 47 46 46 48 42 40 40 40 47 46 48 42 45 3 3 7 1 16 16 16 16 16 16 16 16 16 16 
16 16 16 16 16 16 16 16 16 16 1 8 3 3 44 42 45 3 44 42 42 42 42 45 3 3 44 42 42 42 42 45 3 44 42 45 3 3 7 1 16 16 16 16 16 16 16 16 16 16 
16 16 16 16 16 16 16 16 16 16 1 8 3 3 51 46 53 3 51 46 46 46 46 53 3 3 51 46 46 46 46 53 3 51 46 53 3 3 7 1 16 16 16 16 16 16 16 16 16 16 
16 16 16 16 16 16 16 16 16 16 1 8 3 3 3 3 3 3 3 3 3 3 3 3 3 3 3 3 3 3 3 3 3 3 3 3 3 3 7 1 16 16 16 16 16 16 16 16 16 16 
16 16 16 16 16 16 16 16 16 16 1 8 3 3 3 3 3 3 3 3 3 3 3 3 3 3 3 3 3 3 3 3 3 3 3 3 3 3 7 2 16 16 16 16 16 16 16 16 16 16 
16 16 16 16 16 16 16 16 16 16 1 14 5 5 5 5 5 5 5 5 5 5 5 6 3 3 4 5 5 5 5 5 5 5 5 5 5 5 15 1 16 16 16 16 16 16 16 16 16 16 
16 16 16 16 16 16 16 16 16 16 1 1 16 16 1 2 1 2 1 16 16 16 1 8 3 3 7 1 16 16 16 1 2 1 2 1 16 16 2 1 16 16 16 16 16 16 16 16 16 16 
16 16 16 16 16 16 16 16 16 16 1 12 10 10 10 10 10 10 10 10 10 10 10 11 3 3 9 10 10 10 10 10 10 10 10 10 10 10 13 1 16 16 16 16 16 16 16 16 16 16 
16 16 16 16 16 16 16 16 16 16 1 8 3 3 3 3 3 3 3 3 3 3 3 3 3 3 3 3 3 3 3 3 3 3 3 3 3 3 7 1 16 16 16 16 16 16 16 16 16 16 
16 16 16 16 16 16 16 16 16 16 1 14 5 5 5 5 5 5 5 5 5 5 5 5 5 5 5 5 5 5 5 5 5 5 5 5 5 5 15 1 16 16 16 16 16 16 16 16 16 16 
16 16 16 16 16 16 16 16 16 16 1 1 1 1 1 1 1 1 1 1 1 1 1 1 1 1 1 1 1 1 1 1 1 1 1 1 1 1 1 1 16 16 16 16 16 16 16 16 16 16 
16 16 16 16 16 16 16 16 16 16 1 1 1 1 1 1 1 1 1 1 1 1 1 1 1 1 1 1 1 1 1 1 1 1 1 1 1 1 1 1 16 16 16 16 16 16 16 16 16 16 
21 21 21 21 21 21 21 21 21 21 21 21 21 21 21 21 21 21 21 21 21 21 21 21 21 21 21 21 21 21 21 21 21 21 21 21 21 21 21 21 21 21 21 21 21 21 21 21 21 21 
18 18 18 18 18 18 18 18 18 18 18 18 18 18 18 18 18 18 18 18 18 18 18 18 18 18 18 18 18 18 18 18 18 18 18 18 18 18 18 18 18 18 18 18 18 18 18 18 18 18 
18 18 18 18 18 18 18 18 18 18 18 18 18 18 18 18 18 18 18 18 18 18 18 18 18 18 18 18 18 18 18 18 18 18 18 18 18 18 18 18 18 18 18 18 18 18 18 18 18 18 
18 18 18 18 18 18 18 18 18 18 18 18 18 18 18 18 18 18 18 18 18 18 18 18 18 18 18 18 18 18 18 18 18 18 18 18 18 18 18 18 18 18 18 18 18 18 18 18 18 18 
18 18 18 18 18 18 18 18 18 18 18 18 18 18 18 18 18 18 18 18 18 18 18 18 18 18 18 18 18 18 18 18 18 18 18 18 18 18 18 18 18 18 18 18 18 18 18 18 18 18 
18 18 18 18 18 18 18 18 18 18 18 18 18 18 18 18 18 18 18 18 18 18 18 18 18 18 18 18 18 18 18 18 18 18 18 18 18 18 18 18 18 18 18 18 18 18 18 18 18 18 
