81 81 81 81 81 81 81 81 81 81 81 81 81 81 81 81 81 81 81 81 81 81 81 81 81 81 81 81 81 81 81 81 81 81 81 81 81 81 81 81 81 81 81 81 81 81 81 81 81 81 
81 81 81 81 81 81 81 81 81 81 81 81 81 81 81 81 81 81 81 81 81 81 81 81 81 81 81 81 81 81 81 81 81 81 81 81 81 81 81 81 81 81 81 81 81 81 81 81 81 81 
81 81 81 81 81 81 81 81 81 81 81 81 81 81 81 81 81 81 81 81 81 81 81 81 81 81 81 81 81 81 81 81 81 81 81 81 81 81 81 81 81 81 81 81 81 81 81 81 81 81 
81 81 81 81 81 81 81 81 81 81 81 81 81 81 81 81 81 81 81 81 81 81 81 81 81 81 81 81 81 81 81 81 81 81 81 81 81 81 81 81 81 81 81 81 81 81 81 81 81 81 
81 81 81 81 81 81 81 81 81 81 81 81 81 81 81 81 81 81 81 81 81 81 81 81 81 81 81 81 81 81 81 81 81 81 81 81 81 81 81 81 81 81 81 81 81 81 81 81 81 81 
81 81 81 81 81 81 81 81 81 81 81 81 81 81 81 81 81 81 81 81 81 81 81 81 81 81 81 81 81 81 81 81 81 81 81 81 81 81 81 81 81 81 81 81 81 81 81 81 81 81 
81 81 81 81 81 81 81 81 81 81 81 81 81 96 80 80 80 80 80 80 80 80 80 80 80 80 80 80 80 80 80 80 80 80 80 80 80 81 81 81 81 81 81 81 81 81 81 81 81 81 
81 81 81 81 81 81 81 81 81 81 81 81 82 80 80 80 80 80 80 82 80 80 80 80 80 80 82 80 80 80 80 80 80 80 80 82 80 80 81 81 81 81 81 81 81 81 81 81 81 81 
81 81 81 81 81 81 81 81 81 81 81 80 80 80 80 82 80 80 80 80 80 94 93 93 93 95 80 80 80 80 80 82 80 80 80 80 80 80 80 81 81 81 81 81 81 81 81 81 81 81 
81 81 81 81 81 81 81 81 81 81 130 80 80 80 80 80 80 80 80 94 93 89 83 83 84 92 80 80 80 80 80 80 80 80 82 80 80 82 80 80 81 81 81 81 81 81 81 81 81 81 
81 81 81 81 81 81 81 81 81 81 80 80 80 80 80 80 80 94 93 89 83 83 84 87 92 80 80 80 82 80 80 80 80 80 80 80 96 80 80 80 81 81 81 81 81 81 81 81 81 81 
81 81 81 81 81 81 81 81 81 81 80 80 80 80 80 80 80 88 83 83 83 84 92 81 81 81 81 130 80 80 80 80 80 80 80 80 80 80 80 80 81 81 81 81 81 81 81 81 81 81 
81 81 81 81 81 81 81 81 81 81 80 80 82 80 80 80 94 89 83 83 84 92 81 81 81 81 81 81 96 80 80 80 80 82 80 80 80 82 80 80 81 81 81 81 81 81 81 81 81 81 
81 81 81 81 81 81 81 81 81 81 80 80 80 80 80 80 88 83 83 83 90 81 81 81 81 81 81 81 81 80 80 80 80 80 80 80 80 80 80 80 81 81 81 81 81 81 81 81 81 81 
81 81 81 81 81 81 81 81 81 81 80 80 80 80 80 94 89 83 83 84 92 81 81 81 81 81 81 81 81 80 80 80 80 80 80 80 80 80 80 80 81 81 81 81 81 81 81 81 81 81 
81 81 81 81 81 81 81 81 81 81 80 80 82 80 80 88 83 83 84 92 96 81 81 81 81 81 81 81 81 80 80 80 94 93 93 93 95 80 80 80 81 81 81 81 81 81 81 81 81 81 
81 81 81 81 81 81 81 81 81 81 80 80 80 80 80 91 87 87 92 80 80 81 81 81 81 81 81 81 81 80 80 80 91 85 83 83 86 95 80 80 81 81 81 81 81 81 81 81 81 81 
81 81 81 81 81 81 81 81 81 81 80 80 80 80 80 82 80 82 80 80 80 81 81 81 81 81 81 81 81 80 80 80 96 88 83 83 83 86 95 80 81 81 81 81 81 81 81 81 81 81 
81 81 81 81 81 81 81 81 81 81 80 80 80 80 80 80 80 80 80 80 80 81 81 81 81 81 81 81 81 80 80 80 80 91 85 83 83 83 90 80 81 81 81 81 81 81 81 81 81 81 
81 81 81 81 81 81 81 81 81 81 80 80 80 80 80 80 80 80 80 80 80 81 81 81 81 81 81 81 81 80 80 80 80 80 88 83 83 83 90 96 81 81 81 81 81 81 81 81 81 81 
81 81 81 81 81 81 81 81 81 81 94 93 95 80 80 80 80 80 80 80 80 81 81 81 81 81 81 81 81 80 80 80 80 80 88 83 83 83 86 95 81 81 81 81 81 81 81 81 81 81 
81 81 81 81 81 81 81 81 81 81 88 83 86 93 95 80 80 80 80 82 80 81 81 81 81 81 81 81 81 80 80 80 82 80 91 85 83 83 83 90 81 81 81 81 81 81 81 81 81 81 
81 81 81 81 81 81 81 81 81 81 91 85 83 83 90 80 80 80 80 80 80 81 81 81 81 81 81 81 81 80 80 80 80 80 80 88 83 83 83 90 81 81 81 81 81 81 81 81 81 81 
81 81 81 81 81 81 81 81 81 81 96 88 83 83 86 95 80 80 80 80 80 81 81 81 81 81 81 81 81 80 80 80 80 80 80 91 85 83 83 90 81 81 81 81 81 81 81 81 81 81 
81 81 81 81 81 81 81 81 81 81 80 91 85 83 83 90 80 80 80 80 80 81 81 81 81 81 81 81 81 80 80 80 80 80 80 130 88 83 83 90 81 81 81 81 81 81 81 81 81 81 
81 81 81 81 81 81 81 81 81 81 80 96 88 83 83 86 93 95 80 80 80 81 81 81 81 81 81 81 81 80 80 80 80 80 80 80 88 83 83 90 81 81 81 81 81 81 81 81 81 81 
81 81 81 81 81 81 81 81 81 81 80 80 91 85 83 83 83 90 80 80 80 81 81 81 81 81 81 81 81 80 80 82 80 80 80 80 91 87 87 92 81 81 81 81 81 81 81 81 81 81 
81 81 81 81 81 81 81 81 81 81 80 80 80 91 85 83 83 90 82 80 80 81 81 81 81 81 81 81 81 80 80 80 80 80 80 80 82 80 80 80 81 81 81 81 81 81 81 81 81 81 
81 81 81 81 81 81 81 81 81 81 80 80 80 96 91 87 87 92 80 80 80 81 81 81 81 81 81 81 81 80 80 80 80 80 82 80 80 80 80 80 81 81 81 81 81 81 81 81 81 81 
81 81 81 81 81 81 81 81 81 81 80 80 80 80 80 80 80 82 80 80 80 81 81 81 81 81 81 81 81 94 93 95 80 80 80 80 80 80 80 80 81 81 81 81 81 81 81 81 81 81 
81 81 81 81 81 81 81 81 81 81 80 80 80 80 80 80 80 80 80 80 80 81 81 81 81 81 81 81 81 88 83 86 95 80 80 80 80 80 80 80 81 81 81 81 81 81 81 81 81 16 
81 81 81 81 81 81 81 81 81 81 80 80 80 80 80 82 80 80 80 80 80 81 81 81 81 81 81 81 81 88 83 83 86 95 82 96 80 82 80 80 81 81 81 81 81 81 81 81 81 81 
81 81 81 81 81 81 81 81 81 81 80 80 80 80 80 82 80 80 80 82 80 81 81 81 81 81 81 81 81 91 85 83 83 86 95 80 80 80 80 80 81 81 81 81 81 81 81 81 81 81 
81 81 81 81 81 81 81 81 81 81 80 82 80 80 80 80 80 80 80 80 80 81 81 81 81 81 81 81 81 96 91 85 83 83 86 95 80 80 80 80 81 81 81 81 81 81 81 81 81 81 
81 81 81 81 81 81 81 81 81 81 80 80 80 80 80 80 80 80 80 80 80 81 81 81 81 81 81 81 81 80 80 91 85 83 83 86 95 80 80 80 81 81 81 81 81 81 81 81 81 81 
81 81 81 81 81 81 81 81 81 81 80 80 80 80 82 80 82 80 82 80 80 81 81 81 81 81 81 81 81 80 80 80 91 85 83 83 90 80 80 80 81 81 81 81 81 81 81 81 81 81 
81 81 81 81 81 81 81 81 81 81 80 80 80 80 80 80 80 80 80 80 80 81 81 81 81 81 81 81 81 80 80 80 80 91 87 87 92 80 82 80 81 81 81 81 81 81 81 81 81 81 
81 81 81 81 81 81 81 81 81 81 80 82 80 82 80 82 82 80 80 82 80 81 81 81 81 81 81 81 81 80 80 80 80 80 80 80 80 80 80 80 81 81 81 81 81 81 81 81 81 81 
81 81 81 81 81 81 81 81 81 81 80 80 80 80 80 80 82 80 80 82 80 81 81 81 81 81 81 81 81 80 80 80 80 80 80 80 80 82 80 80 81 81 81 81 81 81 81 81 81 81 
81 81 81 81 81 81 81 81 81 81 80 80 80 80 80 82 80 80 80 80 80 81 81 81 81 81 81 81 81 80 80 130 82 80 80 80 80 130 80 80 81 81 81 81 81 81 81 81 81 81 
81 81 81 81 81 81 81 81 81 81 80 80 80 82 80 80 80 80 80 80 80 81 81 81 81 81 81 81 81 80 80 80 80 80 80 82 80 80 80 80 81 81 81 81 81 81 81 81 81 81 
81 81 81 81 81 81 81 81 81 81 82 80 80 80 80 80 82 80 80 80 80 81 81 81 81 81 81 81 81 81 80 80 80 80 80 80 80 80 80 81 81 81 81 81 81 81 81 81 81 81 
81 81 81 81 81 81 81 81 81 81 80 80 82 80 80 80 80 80 80 82 80 81 81 81 81 81 81 81 81 81 81 80 80 80 82 80 80 80 81 81 81 81 81 81 81 81 81 81 81 81 
81 81 81 81 81 81 81 81 81 81 81 80 80 80 80 80 80 80 80 80 81 81 81 81 81 81 81 81 81 81 81 81 96 102 103 101 96 81 81 81 81 81 81 81 81 81 81 81 81 81 
81 81 81 81 81 81 81 81 81 81 81 81 81 81 81 81 81 81 81 81 81 81 81 81 81 81 81 81 81 81 81 81 81 99 100 98 81 81 81 81 81 81 81 81 81 81 81 81 81 81 
81 81 81 81 81 81 81 81 81 81 81 81 81 81 81 81 81 81 81 81 81 81 81 81 81 81 81 81 81 81 81 81 81 81 81 81 81 81 81 81 81 81 81 81 81 81 81 81 81 81 
81 81 81 81 81 81 81 81 81 81 81 81 81 81 81 81 81 81 81 81 81 81 81 81 81 81 81 81 81 81 81 81 81 81 81 81 81 81 81 81 81 81 81 81 81 81 81 81 81 81 
81 81 81 81 81 81 81 81 81 81 81 81 81 81 81 81 81 81 81 81 81 81 81 81 81 81 81 81 81 81 81 81 81 81 81 81 81 81 81 81 81 81 81 81 81 81 81 81 81 81 
81 81 81 81 81 81 81 81 81 81 81 81 81 81 81 81 81 81 81 81 81 81 81 81 81 81 81 81 81 81 81 81 81 81 81 81 81 81 81 81 81 81 81 81 81 81 81 81 81 81 
81 81 81 81 81 81 81 81 81 81 81 81 81 81 81 81 81 81 81 81 81 81 81 81 81 81 81 81 81 81 81 81 81 81 81 81 81 81 81 81 81 81 81 81 81 81 81 81 81 81 
